
NO ./textures/false.png
SO ./textures/unnamed.png
WE ./textures/unnamed.png
EA ./textures/unnamed.png

F 195,203,110
C 228,230,168

        1111111111111111111111111
        1000000000110000001111001
        1011000001110000001010001
        1001000000000000001111001
111111111011000001110000000001001
100000000011000001110111112111111
11110111111111011100000010001
11110111111111011101010010001
1100E000010101011100000020001
10000000000000000200000010001
10000000000000001101010010001
1100000111111111111101101000111
11110111         1011110P0001
11111111         111111111111
