NO ./textures/unnamed.png
SO ./textures/unnamed.png
WE           ./textures/unnamed.png
EA  ./textures/unnamed.png

F 195,203
C 228,230,168

1111111111111111111111111111
10000000000000N0010000000001
1000000000000000000000000001
100001111100000000010000000111
1111000010002000000000000000001
    1000011111000000001100000001
1111000000000000000001100000001
110000000000000000000000000111
1000011110000000111110000001
10000111100000001    1000001
100001111000000011111000001 
1000000000000000000000000001
111111111111111111111111111