
NO ./textures/unnamed.png
            WE           ./textures/unnamed.png
    EA  ./textures/unnamed.png
SO ./textures/unnamed.png

F 195,203,110
C 228,230,168

1111111111111111111111111111
10000000000000N0000000000001
1000000000000000000000000001
1000011111000000000100000001
1000010002000000000000000001
1000011111000000001100000001
1000000000000000001100000001
1100000000000000000000000001
1000011110000000111000000001
1000011110000000111000000001
1000011110000000111000000001
1000000000000000000000000001
1111111111111111111111111111
