
NO ./textures/unnamed.png
SO ./textures/unnamed.png
WE ./textures/unnamed.png
EA ./textures/unnamed.png

F 255,255,255
C 0,191,255

 111111111
 100000001
 10N000001
 111111111